ICBC	China
JPMorgan Chase	United States
China Construction Bank	China
Agricultural Bank of China	China
Bank of America	United States
Apple	United States
Ping An Insurance Group	China
Bank of China	China
Royal Dutch Shell	Netherlands
Wells Fargo	United States
ExxonMobil	United States
AT&T	United States
Samsung Electronics	South Korea
Citigroup	United States
Toyota Motor	Japan
Microsoft	United States
Alphabet	United States
Volkswagen Group	Germany
Chevron	United States
Verizon Communications	United States
HSBC Holdings	United Kingdom
PetroChina	China
Allianz	Germany
BP	United Kingdom
Total	France
Berkshire Hathaway	United States
China Mobile	Hong Kong
Amazon	United States
Walmart	United States
Santander	Spain
China Merchants Bank	China
UnitedHealth Group	United States
Comcast	United States
BNP Paribas	France
Sinopec	China
Softbank	Japan
Daimler	Germany
Johnson & Johnson	United States
Bank of Communications	China
Gazprom	Russia
RBC	Canada
Nestlé	Switzerland
Mitsubishi UFJ Financial	Japan
Intel	United States
Goldman Sachs Group	United States
TD Bank Group	Canada
Sberbank	Russia
Morgan Stanley	United States
Boeing	United States
Petrobras	Brazil
Nippon Telegraph & Tel	Japan
Rosneft	Russia
Procter & Gamble	United States
Pfizer	United States
Industrial Bank	China
General Motors	United States
BMW Group	Germany
Itaú Unibanco Holding	Brazil
Alibaba	China
IBM	United States
Novartis	Switzerland
Postal Savings Bank Of China (PSBC)	China
Facebook	United States
Siemens	Germany
Shanghai Pudong Development	China
Japan Post Holdings	Japan
Sumitomo Mitsui Financial	Japan
Banco Bradesco	Brazil
Anheuser-Busch InBev	Belgium
Walt Disney	United States
Reliance Industries	India
CITIC	Hong Kong
Sony	Japan
Cisco Systems	United States
Tencent Holdings	China
Honda Motor	Japan
Enel	Italy
United Technologies	United States
Commonwealth Bank	Australia
China State Construction Engineering	China
DowDuPont	United States
Equinor	Norway
American Express	United States
MetLife	United States
AXA Group	France
PepsiCo	United States
Bank of Nova Scotia	Canada
Roche Holding	Switzerland
ING Group	Netherlands
Lloyds Banking Group	United Kingdom
Eni	Italy
Oracle	United States
China Citic Bank	China
China Evergrande Group	China
UBS	Switzerland
AIRBUS	Netherlands
LukOil	Russia
Prudential Financial	United States
BASF	Germany
SAIC Motor	China
Westpac Banking Group	Australia
British American Tobacco	United Kingdom
US Bancorp	United States
Credit Agricole	France
China Life Insurance	China
Unilever	Netherlands
Glencore International	Switzerland
Mitsubishi	Japan
BHP Group	Australia
Ford Motor	United States
Rio Tinto	United Kingdom
Prudential	United Kingdom
AIA Group	Hong Kong
China Minsheng Banking	China
Sanofi	France
Deutsche Telekom	Germany
Zurich Insurance Group	Switzerland
Brookfield Asset Management	Canada
Merck & Co.	United States
ANZ	Australia
Caterpillar	United States
Saudi Basic Industries	Saudi Arabia
Hon Hai Precision	Taiwan
China Vanke	China
Mizuho Financial	Japan
CNOOC	Hong Kong
Home Depot	United States
Taiwan Semiconductor	Taiwan
Country Garden Holdings	China
Capital One Financial	United States
Intesa Sanpaolo	Italy
Nissan Motor	Japan
Coca-Cola	United States
Bank of Montreal	Canada
BBVA-Banco Bilbao Vizcaya	Spain
Walgreens Boots Alliance	United States
Chubb	Switzerland
NAB - National Australia Bank	Australia
Vale	Brazil
China Pacific Insurance	China
Anthem	United States
Telefónica	Spain
Christian Dior	France
Generali Group	Italy
Iberdrola	Spain
PNC Financial Services	United States
GlaxoSmithKline	United Kingdom
Munich Re	Germany
Cigna	United States
Medtronic	Ireland
China Everbright Bank	China
China Shenhua Energy	China
Honeywell International	United States
Banco do Brasil	Brazil
People's Insurance	China
UniCredit	Italy
CK Hutchison	Hong Kong
Société Générale	France
ConocoPhillips	United States
United Parcel Service	United States
VINCI	France
Visa	United States
Tokio Marine Holdings	Japan
Bayer	Germany
PTT PCL	Thailand
Manulife	Canada
AbbVie	United States
China Telecom	China
Phillips 66	United States
KDDI	Japan
Fiat Chrysler Automobiles	United Kingdom
Marathon Petroleum	United States
Costco Wholesale	United States
Enbridge	Canada
Amgen	United States
SAP	Germany
Bank of New York Mellon	United States
Broadcom	United States
SK Hynix	South Korea
China Communications Construction	China
Lockheed Martin	United States
Itochu	Japan
Duke Energy	United States
FedEx	United States
Royal Bank of Scotland	United Kingdom
Orange	France
Barclays	United Kingdom
Union Pacific	United States
América Móvil	Mexico
Canadian Imperial Bank	Canada
Credit Suisse Group	Switzerland
Synchrony Financial	United States
NextEra Energy	United States
Deere & Company	United States
ArcelorMittal	Luxembourg
Mitsui	Japan
Abbott Laboratories	United States
China Railway Group	China
Gilead Sciences	United States
China Railway Construction	China
L'Oréal	France
Exelon	United States
Delta Air Lines	United States
Renault	France
Charter Communications	United States
Micron Technology	United States
Qatar National Bank	Qatar
Deutsche Post	Germany
HDFC Bank	India
Altria Group	United States
Valero Energy	United States
Philip Morris International	United States
DBS	Singapore
BlackRock	United States
Southern Company	United States
3M	United States
Schlumberger	United States
Peugeot	France
Linde	United Kingdom
Oil & Natural Gas	India
Dai-ichi Life Insurance	Japan
Thermo Fisher Scientific	United States
Aflac	United States
Allstate	United States
Hyundai Motor	South Korea
Travelers	United States
ENGIE	France
Mondelez International	United States
Suncor Energy	Canada
Hitachi	Japan
Nordea Bank	Sweden
Aviva	United Kingdom
Target	United States
Lowe's	United States
General Dynamics	United States
Repsol	Spain
AstraZeneca	United Kingdom
Eli Lilly	United States
Continental	Germany
Charles Schwab	United States
National Grid	United Kingdom
Progressive	United States
Tesco	United Kingdom
Danone	France
Poly Developments & Holdings Group	China
Volvo Group	Sweden
HCA Healthcare	United States
Accenture	Ireland
Central Japan Railway	Japan
East Japan Railway	Japan
China Unicom	Hong Kong
Schneider Electric	France
Midea Group	China
KBC Group	Belgium
McDonald's	United States
Denso	Japan
JXTG Holdings	Japan
Fresenius	Germany
BB&T	United States
Gree Electric Appliances	China
Anglo American	United Kingdom
Møller-Maersk	Denmark
E.ON	Germany
MS&AD Insurance	Japan
Huaxia Bank	China
Bristol-Myers Squibb	United States
China Resources Land	Hong Kong
Air Liquide	France
EDF	France
Baoshan Iron & Steel	China
Danaher	United States
Legal & General Group	United Kingdom
EXOR	Netherlands
Sun Life Financial	Canada
BT Group	United Kingdom
KB Financial Group	South Korea
Northrop Grumman	United States
Seven & I Holdings	Japan
HP	United States
Nike	United States
Shinhan Financial Group	South Korea
ABB	Switzerland
Diageo	United Kingdom
Bank of Beijing	China
CNP Assurances	France
Japan Tobacco	Japan
Oversea-Chinese Banking	Singapore
Indian Oil	India
Inditex	Spain
Dominion Resources	United States
Sumitomo	Japan
Occidental Petroleum	United States
Reckitt Benckiser Group	United Kingdom
CRRC	China
Cathay Financial	Taiwan
Kroger	United States
Baidu	China
Panasonic	Japan
Johnson Controls International	Ireland
Ecopetrol	Colombia
Canon	Japan
Royal Ahold Delhaize N.V.	Netherlands
Jardine Matheson	Hong Kong
Raytheon	United States
Sunac China Holdings	China
United Continental Holdings	United States
United Overseas Bank	Singapore
Nippon Steel	Japan
LyondellBasell Industries	United Kingdom
Qualcomm	United States
Safran	France
Carnival	United States
SK Holdings	South Korea
State Street	United States
Orix	Japan
Celgene	United States
American Electric	United States
PayPal	United States
EOG Resources	United States
Greenland Holdings Group	China
LafargeHolcim	Switzerland
Henkel	Germany
Posco	South Korea
Natixis	France
Mitsubishi Electric	Japan
Bridgestone	Japan
Archer Daniels Midland	United States
Sun Hung Kai Properties	Hong Kong
Toshiba	Japan
Surgutneftegas	Russia
Poste Italiane	Italy
HDFC	India
First Abu Dhabi Bank	United Arab Emirates
Mastercard	United States
Kinder Morgan	United States
New China Life Insurance	China
DNB	Norway
SunTrust Banks	United States
Danske Bank	Denmark
Discover Financial Services	United States
BCE	Canada
Canadian Natural Resources	Canada
CaixaBank	Spain
CSX	United States
Longfor Group Holdings	China
TransCanada	Canada
Bank Of Shanghai	China
Macquarie Group	Australia
Fubon Financial	Taiwan
Marubeni	Japan
Starbucks	United States
Fannie Mae	United States
Samsung Life Insurance	South Korea
Tyson Foods	United States
Becton Dickinson	United States
Automatic Data Processing	United States
Humana	United States
Standard Chartered	United Kingdom
Imperial Brands	United Kingdom
Richemont	Switzerland
Eaton	Ireland
Kering	France
Bank Rakyat Indonesia (BRI)	Indonesia
Couche Tard	Canada
Saudi Telecom	Saudi Arabia
Stryker	United States
Freddie Mac	United States
Daiwa House Industry	Japan
Heineken	Netherlands
Booking Holdings	United States
NN Group	Netherlands
Ameriprise Financial	United States
American Airlines Group	United States
Tata Consultancy Services	India
Mitsui Fudosan	Japan
Novo Nordisk	Denmark
Takeda Pharmaceutical	Japan
Maybank	Malaysia
China Merchants Shekou Industrial Zone Holdings	China
Norfolk Southern	United States
Power Construction Corporation of China	China
Michelin Group	France
EssilorLuxottica	France
Etisalat	United Arab Emirates
CRH	Ireland
Lincoln National	United States
Transneft	Russia
Canadian National Railway	Canada
General Electric	United States
Hyundai Mobis	South Korea
Erste Group Bank	Austria
Swiss Life Holding	Switzerland
ASML Holding	Netherlands
Komatsu	Japan
Suzuki Motor	Japan
TJX Cos	United States
Power Corp of Canada	Canada
Southwest Airlines	United States
Telstra	Australia
ICICI Bank	India
Freeport-McMoRan	United States
Texas Instruments	United States
Sompo	Japan
Principal Financial Group	United States
OMV Group	Austria
Shin-Etsu Chemical	Japan
Anhui Conch Cement	China
Hartford Financial Services	United States
SingTel	Singapore
CVS Health	United States
Marriott International	United States
AmerisourceBergen	United States
Deutsche Lufthansa	Germany
Tokyo Electric Power	Japan
Standard Bank Group	South Africa
Fosun International	China
SEB AB	Sweden
Naspers	South Africa
Kweichow Moutai	China
National Commercial Bank	Saudi Arabia
Bank Of Jiangsu	China
Biogen	United States
Suning.com	China
Bouygues	France
Wilmar International	Singapore
Xiaomi	China
Magna International	Canada
International Airlines	United Kingdom
Femsa	Mexico
Adidas	Germany
Netflix	United States
Philips	Netherlands
Sumitomo Mitsui Trust	Japan
China Yangtze Power	China
Applied Materials	United States
Paccar	United States
Sysco	United States
Larsen & Toubro	India
Emerson Electric	United States
Samsung C&T	South Korea
International Paper	United States
Halliburton	United States
China Cinda Asset Management	China
Daikin Industries	Japan
FirstRand	South Africa
Salesforce.com	United States
KIA Motors	South Korea
CK Asset Holdings	Hong Kong
Consolidated Edison	United States
Svenska Handelsbanken	Sweden
Swire Pacific	Hong Kong
General Mills	United States
CTBC Financial	Taiwan
SK Innovation	South Korea
Pernod Ricard	France
Citic Securities	China
New World Development	Hong Kong
Waste Management	United States
Sempra Energy	United States
Aegon	Netherlands
State Bank of India	India
American International Group	United States
Toyota Industries	Japan
Vodafone	United Kingdom
Sampo	Finland
Subaru	Japan
IntercontinentalExchange	United States
LG Chem	South Korea
Fifth Third Bank	United States
Dell Technologies	United States
SK Telecom	South Korea
VTB Bank	Russia
Banorte	Mexico
Swiss Re	Switzerland
Mitsubishi Chemical	Japan
Centene	United States
BAE Systems	United States
Hana Financial Group	South Korea
Fast Retailing	Japan
CNH Industrial	United Kingdom
Bank Mandiri	Indonesia
HeidelbergCement	Germany
Hewlett Packard Enterprise	United States
Talanx	Germany
Cummins	United States
Orsted	Denmark
WPP	United Kingdom
Marsh & McLennan	United States
Grupo ACS	Spain
Xcel Energy	United States
Las Vegas Sands	United States
NTPC	India
China Zheshang Bank	China
Commerzbank	Germany
Toyota Tsusho	Japan
Lennar	United States
Swedbank	Sweden
Compass Group	United Kingdom
Woolworths	Australia
Novatek	Russia
National Bank of Canada	Canada
LG Electronics	South Korea
Thales	France
Public Service Enterprise Group	United States
Adobe	United States
China Taiping Insurance	Hong Kong
TE Connectivity	Switzerland
Mitsubishi Estate	Japan
Metallurgical Corp of China	China
Emirates NBD	United Arab Emirates
Kansai Electric Power	Japan
Ecolab	United States
DXC Technology	United States
M&T Bank	United States
Fujitsu	Japan
Constellation Brands	United States
Wesfarmers	Australia
CLP Holdings	Hong Kong
Al Rajhi Bank	Saudi Arabia
Asahi Group Holdings	Japan
Illinois Tool Works	United States
Fujifilm Holdings	Japan
Saint-Gobain	France
Cognizant	United States
Tatneft	Russia
DTE Energy	United States
KeyCorp	United States
Recruit Holdings	Japan
NVIDIA	United States
Sasol	South Africa
JFE Holdings	Japan
Bank of Ningbo	China
eBay	United States
Mitsubishi Heavy Industries	Japan
Citizens Financial Group	United States
Weichai Power	China
Nucor	United States
Sherwin-Williams	United States
Formosa Petrochemical	Taiwan
Ally Financial	United States
Murata Manufacturing	Japan
Northern Trust	United States
American Tower	United States
China Fortune Land Development	China
CME Group	United States
Samsung Fire & Marine	South Korea
Deutsche Bank	Germany
Kraft Heinz Company	United States
Qingdao Haier	China
Associated British Foods	United Kingdom
MTR	Hong Kong
Tata Steel	India
Bank Central Asia	Indonesia
Bank of Nanjing	China
Telenor	Norway
Colgate-Palmolive	United States
Boston Scientific	United States
Kimberly-Clark	United States
China National Building	China
CBS	United States
Dollar General	United States
DISH Network	United States
Keurig Dr Pepper	United States
Kubota	Japan
Rakuten	Japan
Merck	United States
Rogers Communications	Canada
PPL	United States
Aisin Seiki	Japan
Aroundtown	Luxembourg
Aon	United Kingdom
Sinopharm Group	China
Royal Caribbean Cruises	United States
Norilsk Nickel	Russia
Woori Financial Group	South Korea
Kirin Holdings	Japan
NXP Semiconductors	Netherlands
Saudi Electricity	Saudi Arabia
Swisscom	Switzerland
McKesson	United States
Nidec	Japan
Omnicom Group	United States
Coal India	India
RELX	United Kingdom
Ingersoll Rand	Ireland
FirstEnergy	United States
Anadarko Petroleum	United States
Korea Electric Power	South Korea
Regions Financial	United States
Simon Property Group	United States
Corning	United States
The Estée Lauder Companies	United States
Henderson Land	Hong Kong
Grupo Mexico	Mexico
Allergan	Ireland
H&M - Hennes & Mauritz	Sweden
Loews	United States
VMware	United States
Best Buy	United States
First Data	United States
Air Products & Chemicals	United States
Astellas Pharma	Japan
Asahi Kasei	Japan
Entergy	United States
Ageas	Belgium
PPG	United States
Shimao Property Holdings	Hong Kong
Sumitomo Electric	Japan
Formosa Chemicals	Taiwan
Atlantia	Italy
Kotak Mahindra Bank	India
Tenaga Nasional	Malaysia
JD.com	China
Wheelock	Hong Kong
Western Digital	United States
Industrial Bank of Korea	South Korea
Baxter International	United States
Dongfeng Motor Group	China
Nintendo	Japan
Aeon	Japan
Coca-Cola European Partners	United Kingdom
Vonovia	Germany
Teck Resources	Canada
Evonik	Germany
TELUS	Canada
RWE Group	Germany
Devon Energy	United States
Bharat Petroleum	India
Eversource Energy	United States
Oneok	United States
TD Ameritrade Holding	United States
Siam Commercial Bank	Thailand
Edp-energias De Portugal	Portugal
Resona Holdings	Japan
Sumitomo Realty	Japan
Raiffeisen Bank International	Austria
Daqin Railway	China
Idemitsu Kosan	Japan
Unibail-Rodamco	Netherlands
Parker-Hannifin	United States
BOE Technology Group	China
Nokia	Finland
Infosys	India
Public Bank	Malaysia
Kao	Japan
Mapfre	Spain
Geely Automobile Holdings	Hong Kong
Siam Cement	Thailand
Nan Ya Plastics	Taiwan
PKN Orlen	Poland
Naturgy Energy Group	Spain
Kellogg	United States
WEC Energy Group	United States
CNPC Capital	China
Kyocera	Japan
Telia	Sweden
Eletrobrás	Brazil
Guangzhou Automobile Group	China
CIMB Group Holdings	Malaysia
Prologis	United States
Absa Group	South Africa
Sodexo	France
Isbank	Turkey
Carrefour	France
Republic Services	United States
Publicis Groupe	France
Porsche Automobil Holding	Germany
D.R. Horton	United States
Kasikornbank	Thailand
Capgemini	France
Ross Stores	United States
Deutsche Boerse	Germany
Grupo Aval	Colombia
Husky Energy	Canada
CGN Power	China
West Japan Railway	Japan
Legend Holding	China
Nutrien	Canada
Activision Blizzard	United States
Toray Industries	Japan
Chubu Electric Power	Japan
China Tower Corp.	China
Analog Devices	United States
Grupa PZU	Poland
Viacom	United States
Fidelity National Information	United States
Sekisui House	Japan
Akzo Nobel	Netherlands
Huntington Bank	United States
WH Group	Hong Kong
Molson Coors Brewing	United States
Haitong Securities	China
AES	United States
Tesla	United States
Falabella	Chile
Fox	United States
Veolia Environnement	France
Link REIT	Hong Kong
Lenovo Group	Hong Kong
Atlas Copco	Sweden
Suncorp Group	Australia
All Nippon Airways	Japan
T&D Holdings	Japan
Lam Research	United States
Pioneer Natural Resources	United States
Vivendi	France
VF	United States
Solvay	Belgium
UPM-Kymmene	Finland
Uniper	Germany
National Bank of Kuwait	Kuwait
Samba Financial Group	Saudi Arabia
China Southern Airlines	China
Nomura	Japan
Reinsurance Group of America	United States
Eiffage	France
Cardinal Health	United States
Crown Castle International	United States
Ericsson	Sweden
Sumitomo Chemical	Japan
Tokyo Electron	Japan
Willis Towers Watson	United Kingdom
CBRE Group	United States
Essity Ab	Sweden
Sandvik	Sweden
CSL	Australia
Credicorp	Peru
Riyad Bank	Saudi Arabia
London Stock Exchange	United Kingdom
Guotai Junan Securities	China
DSM	Netherlands
Bancolombia	Colombia
Rolls-Royce Holdings	United Kingdom
Hong Kong Exchanges	Hong Kong
Otsuka Holding	Japan
Stanley Black & Decker	United States
BYD	China
WestRock	United States
CarMax	United States
Aptiv	Ireland
Axis Bank	India
CenturyLink	United States
Fortive	United States
George Weston	Canada
Koç Holding	Turkey
Huaneng Power International	China
Isuzu Motors	Japan
Telkom Indonesia	Indonesia
China Energy Engineering	China
Unipol Gruppo	Italy
Teva Pharmaceutical	Israel
Keyence	Japan
Neste	Finland
Shanghai International Port	China
Nedbank	South Africa
Bangkok Bank	Thailand
China Reinsurance Group	China
Formosa Plastics	Taiwan
Telecom Italia	Italy
Concho Resources	United States
Covestro	Germany
Guangzhou R&F	China
LG	South Korea
Liberty Global	United Kingdom
Raymond James Financial	United States
Fairfax Financial	Canada
ROSSETI	Russia
China Eastern Airlines	China
Tata Motors	India
AIB Group	Ireland
Fortis (Canada)	Canada
Woodside Petroleum	Australia
China Steel	Taiwan
First Republic Bank	United States
ATOS	France
Japan Airlines	Japan
Garanti Bank	Turkey
Edison International	United States
Galp Energia	Portugal
Infineon Technologies	Germany
Athene Holding	Bermuda
Old Mutual	South Africa
AutoZone	United States
Abu Dhabi Commercial Bank	United Arab Emirates
Yanzhou Coal Mining	China
Macy's	United States
NetEase	China
Hermès International	France
Fanuc	Japan
Regeneron Pharmaceuticals	United States
Novolipetsk Steel	Russia
Hanwha	South Korea
Dentsu	Japan
Carlsberg	Denmark
Textron	United States
Bank of Jinzhou	China
SSE	United Kingdom
Huatai Securities	China
Lotte Chemical	South Korea
Hikvision	China
QBE Insurance Group	Australia
Shaanxi Coal Industry	China
Shanghai Electric Group	China
Saudi British Bank	Saudi Arabia
O'Reilly Automotive	United States
ITC	India
Chunghwa Telecom	Taiwan
Shenzhen Overseas	China
EnBW-Energie Baden	Germany
Comerica	United States
Inner Mongolia Yili	China
Genuine Parts	United States
PKO Bank Polski	Poland
PG&E	United States
Discovery	United States
Ferguson	United Kingdom
Huishang Bank	China
Sanlam	South Africa
Williams	United States
Deutsche Wohnen	Germany
S&P Global	United States
Wanhua Chemical Group	China
Fortum	Finland
Mega Financial Holding	Taiwan
JBS	Brazil
China Coal Energy	China
Emaar Properties	United Arab Emirates
Canadian Pacific Railway	Canada
Evraz Group	United Kingdom
Mitsubishi Motors	Japan
Wuliangye Yibin	China
Intuit	United States
LabCorp	United States
PTT Global Chemical	Thailand
Bank Negara Indonesia	Indonesia
Galaxy Entertainment	Hong Kong
Gemdale	China
E-Trade Financial	United States
Kuehne & Nagel International	Switzerland
Kone	Finland
Ryanair Holdings	Ireland
Great Wall Motor	China
MGM Resorts	United States
Tokyo Gas	Japan
YPF	Argentina
Daiwa Securities	Japan
ThyssenKrupp Group	Germany
Vestas Wind Systems	Denmark
Sabanci Holding	Turkey
Mazda Motor	Japan
DP World	United Arab Emirates
Bharti Airtel	India
Valeo	France
Ameren	United States
Secom	Japan
Brighthouse Financial	United States
Hilton	United States
Wipro	India
Itaúsa	Brazil
China Huarong Asset Management	China
Amphenol	United States
Daiichi Sankyo	Japan
JSW Steel	India
Schindler Holding	Switzerland
Power Grid of India	India
Scentre Group	Australia
Seagate Technology	Ireland
OTP Bank	Hungary
Aena	Spain
Akbank	Turkey
SVB Financial Group	United States
Unum	United States
Towngas	Hong Kong
Kuwait Finance House	Kuwait
Future Land Development Holdings	China
Hindalco Industries	India
China Resources Pharmaceutical Group	Hong Kong
Eastman Chemical	United States
HCL Technologies	India
Conagra Brands	United States
CP All	Thailand
Stora Enso	Finland
Bank Leumi	Israel
Lear	United States
Kohl's	United States
MOL Hungarian Oil	Hungary
Xiamen C&D	China
S.F. Holding	China
Zijin Mining Group	China
CapitaLand	Singapore
Steinhoff International	Netherlands
Inpex	Japan
China National Nuclear Power	China
GF Securities	China
Zoetis	United States
Halkbank	Turkey
Pembina Pipeline	Canada
ASE Technology Holding	Taiwan
Taisei	Japan
TDK	Japan
Shenwan Hongyuan Group	China
Weyerhaeuser	United States
Kajima	Japan
Banque Saudi Fransi	Saudi Arabia
Cheniere Energy	United States
STMicroelectronics	Switzerland
L3Harris Technologies	United States
VakifBank	Turkey
Randstad Holding	Netherlands
South32	Australia
United Rentals	United States
Braskem	Brazil
Mediobanca	Italy
Arrow Electronics	United States
Marathon Oil	United States
Obayashi	Japan
RiseSun Real Estate Development	China
Hormel Foods	United States
Alliance Data Systems	United States
Franklin Resources	United States
China Hongqiao Group	China
Hershey	United States
CMS Energy	United States
Aluminum Corp of China	China
Severstal	Russia
Dubai Islamic Bank	United Arab Emirates
BAIC Motor	China
Julius Baer Group	Switzerland
Roper Technologies	United States
Swatch Group	Switzerland
Snam	Italy
Norsk Hydro	Norway
AntarChile	Chile
Suntory Beverage & Food	Japan
Fortescue Metals Group	Australia
MTN Group	South Africa
TCL	China
China Merchants Securities	China
Quanta Computer	Taiwan
KT	South Korea
Shanghai Pharmaceuticals	China
Scor	France
Bankia	Spain
Dollar Tree	United States
Origin Energy	Australia
Shengjing Bank	China
Ball	United States
China Gezhouba	China
Yum! Brands	United States
Air France-KLM	France
Amadeus IT Group	Spain
AGC	Japan
Arch Capital Group	Bermuda
CDW	United States
Tenaris	Luxembourg
Bank of Ireland	Ireland
Logan Property Holdings	China
Arconic	United States
Bank Hapoalim	Israel
Beiersdorf	Germany
IQVIA	United States
Vertex Pharmaceuticals	United States
Alstom	France
AvalonBay Communities	United States
CEZ Group	Czech Republic
Fiserv	United States
Bâloise Group	Switzerland
China Grand Automotive Services	China
Mylan	United Kingdom
Bank of East Asia	Hong Kong
Qurate Retail Group	United States
Krung Thai Bank	Thailand
Mahindra & Mahindra	India
CGI Group	Canada
Cemex	Mexico
Altice USA	United States
Cosco Shipping	China
Sharp	Japan
WW Grainger	United States
Leonardo	Italy
Gap	United States
American Financial Group	United States
Uni-President	Taiwan
Korea Gas	South Korea
Cenovus Energy	Canada
CenterPoint Energy	United States
Motorola Solutions	United States
SMC	Japan
Meituan Dianping	China
T Rowe Price	United States
Agile Group Holdings	China
TUI	Germany
Expedia Group	United States
Public Storage	United States
Guangzhou Rural Commercial Bank	China
Zions Bancorp	United States
Shiseido	Japan
C.H. Robinson	United States
WR Berkley	United States
Samsung SDI	South Korea
ZTE	China
Voya Financial	United States
Arab National Bank	Saudi Arabia
Centrica	United Kingdom
Financiere de l'Odet	France
Wens Foodstuff Group	China
Electronic Arts	United States
Bank Of Hangzhou	China
GS Holdings	South Korea
Pgnig Group	Poland
HollyFrontier	United States
DSV	Denmark
Intuitive Surgical	United States
Legrand	France
Inner Mongolia Baotou Steel	China
En+ Group Plc Sponsored GDR RegS	United Kingdom
Sany Heavy Industry	China
BDO Unibank	Philippines
China Gas Holdings	Hong Kong
Aeroports de Paris	France
Diamondback Energy	United States
Asr Nederland	Netherlands
NEC	Japan
Db Insurance	South Korea
JM Smucker	United States
Schaeffler	Germany
Zimmer Biomet	United States
China Jinmao	Hong Kong
Hengli Petrochemical	China
ALFA	Mexico
Shanghai Construction	China
Qatar Islamic Bank	Qatar
CJ Cheiljedang	South Korea
Turkish Airlines	Turkey
Thomson Reuters	Canada
Investor AB	Sweden
Adecco	Switzerland
Rockwell Automation	United States
Moody's	United States
Datang International Power	China
Accor	France
IndusInd Bank	India
Intact Financial	Canada
J Sainsbury	United Kingdom
Thai Beverage	Thailand
Yamaha Motor	Japan
Cintas	United States
Beijing Enterprises	Hong Kong
Gallagher	United States
Continental Resources	United States
Daito Trust Construction	Japan
China Shipbuilding Industry	China
Shin Kong Financial	Taiwan
BBMG	China
MediaTek	Taiwan
Onex	Canada
Tokyu	Japan
WellCare Health Plans	United States
Mitsubishi UFJ Lease	Japan
Celanese	United States
Hesteel	China
Interactive Brokers Group	United States
Sumitomo Metal Mining	Japan
Japan Exchange Group	Japan
Mohawk Industries	United States
Sojitz	Japan
Investec	United Kingdom
NetApp	United States
Yum China Holdings	China
Melrose Industries Plc	United Kingdom
Universal Health	United States
Gecina	France
Restaurant Brands International	Canada
Dexia	Belgium
Norwegian Cruise Line Holdings	United States
Sika	Switzerland
Zhejiang Zheneng Electric Power	China
Singapore Airlines	Singapore
Technipfmc	United Kingdom
BCI-Banco Credito	Chile
SDIC Power Holdings	China
Dassault Aviation	France
First Financial Holding	Taiwan
Barrick Gold	Canada
Shimizu	Japan
Vistra Energy	United States
Invesco	United States
Mosaic	United States
Oi	Brazil
Jiangsu Yanghe Brewery	China
Klepierre	France
SM Investments	Philippines
Harris	United States
Agilent Technologies	United States
Altice Europe	Netherlands
Joint Stock Commercial Bank for Foreign Trade of Vietnam	Vietnam
Kyushu Electric Power	Japan
Markel	United States
Welltower	United States
Twitter	United States
Kerry Group	Ireland
Angang Steel	China
Hoya	Japan
Illumina	United States
Mondi	United Kingdom
Steel Dynamics	United States
Bajaj Finserv	India
Boston Properties	United States
Insurance Australia Group	Australia
American Water Works	United States
Goodyear	United States
Banco de Sabadell	Spain
Knorr-Bremse	Germany
Annaly Capital Management	United States
Helvetia Holding	Switzerland
LG Display	South Korea
Harbin Bank	China
Alinma Bank	Saudi Arabia
Grupo Inbursa	Mexico
AGL Energy	Australia
E.Sun Financial	Taiwan
Paychex	United States
AerCap Holdings	Ireland
Rongsheng Petrochemical	China
Bunge	United States
Meiji Holdings	Japan
Bankinter	Spain
Westlake Chemical	United States
Grifols	Spain
KLA-Tencor	United States
Monster Beverage	United States
Darden Restaurants	United States
Ferrovial	Spain
Encana	Canada
Taiwan Cooperative Financial	Taiwan
Industries Qatar	Qatar
Clorox	United States
Lonza Group	Switzerland
Hankyu Hanshin Holdings	Japan
Ternium	Luxembourg
Tohoku Electric Power	Japan
BorgWarner	United States
Attijariwafa Bank	Morocco
Ulta Beauty	United States
CIFI Holdings Group	China
Samsung SDS	South Korea
Molina Healthcare	United States
Saudi Arabian Mining	Saudi Arabia
Interpublic Group	United States
Skanska	Sweden
Amcor	Australia
Guosen Securities	China
SGS	Switzerland
Tokyo Century	Japan
Evergy	United States
PVH	United States
Host Hotels & Resorts	United States
Saputo	Canada
Whirlpool	United States
TransDigm Group	United States
Kobe Steel	Japan
Voestalpine	Austria
Aramark	United States
China Galaxy Securities	China
China International Marine	China
CJ Corporation	South Korea
Jeronimo Martins	Portugal
Terna	Italy
PulteGroup	United States
China Development Financial	Taiwan
China Resources Power	Hong Kong
Bank Pekao	Poland
Covivio	France
Oriental Land	Japan
Xilinx	United States
Schroders	United States
Wynn Resorts	United States
Bank of Tianjin	China
GD Power Development	China
Equinix	United States
UBI Banca	Italy
Cosmo Energy Holdings	Japan
UCB	Belgium
3i Group	United Kingdom
Yara International	Norway
GAIL India	India
Givaudan	Switzerland
Hyundai Steel	South Korea
Inter Rao	Russia
Ferrari	Italy
Industrial Alliance Insurance	Canada
Vienna Insurance Group	Austria
Petronas Chemicals	Malaysia
Terumo	Japan
Newmont Mining	United States
Masco	United States
Ricoh	Japan
Top Frontier Investment Holdings	Philippines
Punjab National Bank	India
Edwards Lifesciences	United States
Pegatron	Taiwan
Indorama Ventures	Thailand
Bank Of Guiyang	China
S-Oil	South Korea
Arkema	France
Airports of Thailand	Thailand
NRG Energy	United States
Dassault Systemes	France
Experian	Ireland
US Steel	United States
Advanced Info Service	Thailand
Expeditors International	United States
Jiangsu Hengrui Medicine	China
Hess	United States
HAL Trust	Monaco
LG Household & Health Care	South Korea
Grasim Industries	India
Phoenix Group Holdings	United Kingdom
Assa Abloy	Sweden
Charoen Pokphand Foods	Thailand
Worldpay	United States
Yuanta Financial Holding	Taiwan
Concordia Financial Group	Japan
SKF Group	Sweden
Genworth Financial	United States
Bank of Baroda	India
Jiangxi Copper	China
Bank of Changsha	China
China Mengniu Dairy	Hong Kong
Grupo Elektra	Mexico
HCP	United States
Equity Residential	United States
Shionogi	Japan
Foshan Haitian Flavouring and Food	China
Quest Diagnostics	United States
Ayala	Philippines
China International Capital	China
Magnitogorsk Iron & Steel	Russia
Ashtead Group	United Kingdom
Bank Of Chengdu	China
Brown-Forman	United States
Hunan Valin Steel	China
Delta Electronics	Taiwan
East West Bancorp	United States
New Residential Investment	United States
Fastenal	United States
Power Finance	India
Henry Schein	United States
FleetCor Technologies	United States
Hexagon	Sweden
Dai Nippon Printing	Japan
Metro Group	Germany
Goodman Group	Australia
Torchmark	United States
Ctrip.com International	China
China Life Insurance (Taiwan)	Taiwan
McCormick	United States
Storebrand	Norway
HNA Technology	China
Apache	United States
Brenntag	Germany
RSA Insurance Group	United Kingdom
NVR	United States
Skyworks Solutions	United States
China International Travel Service	China
Johnson Matthey	United Kingdom
Hua Nan Financial	Taiwan
Huntington Ingalls Industries	United States
Unicharm	Japan
China Molybdenum	China
Yango Group	China
Wolters Kluwer	Netherlands
Hyundai Marine & Fire	South Korea
Umicore	Belgium
Waste Connections	Canada
Sino-Ocean Group Holding	China
AGNC Investment	United States
Signature Bank	United States
Cerner	United States
Huadian Power International	China
Power Assets Holdings	Hong Kong
Ahli United Bank	Bahrain
Qantas Airways	Australia
Ametek	United States
Cathay Pacific Airways	Hong Kong
LKQ	United States
LARGAN Precision	Taiwan
X5 Retail Group	Netherlands
Canara Bank	India
Digital Realty Trust	United States
Crown Holdings	United States
Doosan	South Korea
Valeant Pharmaceuticals	Canada
Transurban Group	Australia
Mitsui Chemicals	Japan
Maanshan Iron & Steel	China
Jacobs Engineering	United States
Partners Group Holding	Switzerland
AVIC Capita	China
Focus Media Information Technology	China
Koito Manufacturing	Japan
Check Point Software	Israel
Quinenco	Chile
Leidos	United States
Dover	United States
Grupo Bimbo	Mexico
Sino Biopharmaceutical	Hong Kong
Everest Re Group	Bermuda
Jinke Property Group	China
Bombardier	Canada
L Brands	United States
Wuestenrot & Wuerttembergische	Germany
DaVita	United States
Ventas	United States
Coca-Cola HBC	Switzerland
Tenet Healthcare	United States
Metro	Canada
Bluescope Steel	Australia
Hyundai Heavy Industries	South Korea
Techtronic Industries	Hong Kong
Fukuoka Financial Group	Japan
Tractor Supply	United States
National Oilwell Varco	United States
Shanxi Taigang Stainless	China
Shinsei Bank	Japan
Lotte Shopping	South Korea
Alrosa	Russia
Fidelity National Financial	United States
RTL Group	Luxembourg
Manpower	United States
Navient	United States
Banco BPM	Italy
Chow Tai Fook Jewellery	Hong Kong
Bank of India	India
Liberty Expedia Holdings	United States
Shenzhou International Group Holdings	Hong Kong
Bunzl	United Kingdom
US Foods	United States
Chugoku Electric Power	Japan
Contemporary Amperex Technology	China
Emera	Canada
KION Group	Germany
Daishi Hokuetsu Financial Group	Japan
RHB Bank	Malaysia
Nordstrom	United States
Yamato Holdings	Japan
Chesapeake Energy	United States
NARI Technology Development	China
Santos	Australia
Eisai	Japan
Electric Power Development	Japan
Targa Resources	United States
Keppel	Singapore
Advance Auto Parts	United States
Bank of Chongqing	China
Popular	United States
Zhongsheng Group Holdings	China
IHS Markit	United Kingdom
Campbell Soup	United States
Microchip Technology	United States
Coloplast	Denmark
STRABAG	Austria
Chiba Bank	Japan
Colruyt	Belgium
Brambles	Australia
Hydro One	Canada
Verisk Analytics	United States
Oji Holdings	Japan
Greentown China Holdings	China
Magnit	Russia
Osaka Gas	Japan
Segro	United Kingdom
Alleghany	United States
Olam International	Singapore
Bohai Leasing	China
Jones Lang LaSalle	United States
Smith & Nephew	United Kingdom
J.B. Hunt Transport Services	United States
Medipal Holdings	Japan
360 Security Technology	China
Coty	United States
VeriSign	United States
St. James's Place	United Kingdom
Barratt Developments	United Kingdom
BPER Banca	Italy
Maxim Integrated Products	United States
Meritz Financial Group	South Korea
Red Eléctrica	Spain
NEXON	Japan
Packaging Corp of America	United States
Shanghai International Airport	China
Materials Industry Zhongda Group	China
Hainan Airlines	China
Cincinnati Financial	United States
Garmin	Switzerland
Canadian Tire	Canada
Nine Dragons Paper Holdings	Hong Kong
Nippon Yusen	Japan
Kintetsu	Japan
Verbund	Austria
Anta Sports Products	China
IAC/InterActiveCorp	United States
Global Payments	United States
Penske Automotive	United States
Showa Denko	Japan
Shizuoka Bank	Japan
Persimmon	United Kingdom
Alfresa Holdings	Japan
Live Nation Entertainment	United States
XPO Logistics	United States
Lixil Group	Japan
Bank of Zhengzhou	China
OMRON	Japan
DCC	Ireland
Sun Art Retail Group	Hong Kong
Beijing Capital Development	China
Advanced Micro Devices	United States
Nitori Holdings	Japan
Arca Continental	Mexico
Masraf Al Rayan	Qatar
BNK Financial Group	South Korea
Assurant	United States
NASDAQ	United States
Bawag Group	Austria
Shanghai Commercial & Savings Bank	Taiwan
Iida Group Holdings	Japan
Mirae Asset Daewoo	South Korea
Far East Horizon	Hong Kong
CSN	Brazil
Bank Of Gansu	China
People's United Financial	United States
E-mart	South Korea
Kerry Properties	Hong Kong
ENN Energy Holdings	China
Next	United Kingdom
Tech Data	United States
Wm Morrison Supermarkets	United Kingdom
Hong Leong Financial	Malaysia
Arab Bank	Jordan
Sekisui Chemical	Japan
Korea Investment Holdings	South Korea
Flex	Singapore
Naver	South Korea
Orient Securities	China
Union Bank of India	India
Korean Air	South Korea
Mebuki Financial Group	Japan
Gudang Garam	Indonesia
American Equity Investment	United States
Spirit AeroSystems	United States
Ooredoo Q.P.S.C	Qatar
Yonghui Superstores	China
Chongqing Rural Bank	China
First Horizon National	United States
Electrolux Group	Sweden
Synopsys	United States
Mitsubishi Materials	Japan
Church & Dwight	United States
Xylem	United States
Total System Services	United States
China Merchants Port Holdings	Hong Kong
Tapestry	United States
Compal Electronics	Taiwan
Red Hat	United States
Proximus	Belgium
Waters	United States
Sistema	Russia
Mashreq Bank	United Arab Emirates
Pinnacle West	United States
Vornado Realty	United States
Xiamen International Trade Group	China
Reliance Steel	United States
Abu Dhabi Islamic Bank	United Arab Emirates
AECOM Technology	United States
Bank Audi	Lebanon
Kawasaki Heavy Industries	Japan
Toppan Printing	Japan
Boliden	Sweden
Cielo	Brazil
Lululemon Athletica	Canada
Empresas CMPC	Chile
Nitto Denko	Japan
Huntsman	United States
Antofagasta	United Kingdom
Beijing Shougang	China
B3	Brazil
Realty Income	United States
Bandai Namco Holdings	Japan
Xinyu Iron & Steel	China
Alliant Energy	United States
Sinotruk Hong Kong	China
Geberit	Switzerland
KT&G	South Korea
Spotify Technology	Luxembourg
Yandex NV	Netherlands
Alexion Pharmaceuticals	United States
Micro Focus International	United Kingdom
Mitsui OSK Lines	Japan
Cattolica Assicurazioni	Italy
Hyundai Engineering	South Korea
Chang Hwa Bank	Taiwan
China Communications Services	China
Bajaj Auto	India
Kingfisher	United Kingdom
CIT Group	United States
Nippon Express	Japan
Dexus	Australia
El Puerto de Liverpool	Mexico
Israel Discount Bank	Israel
Maroc Telecom	Morocco
MSCI	United States
Mettler-Toledo International	United States
Taishin Financial Holdings	Taiwan
Xerox	United States
Western Union	United States
Hang Lung Group	Hong Kong
SEB SA	France
Cencosud	Chile
ICA Gruppen	Sweden
Jyske Bank	Denmark
KPN	Netherlands
Ceconomy	Germany
Halyk Bank	Kazakhstan
Kaisa Group Holdings	China
Jiangxi Bank	China
Finatis	France
Zhongyuan Bank	China
Banca MPS	Italy
Lindt & Sprungli	Switzerland
Dangote Cement	Nigeria
Epiroc	Sweden
Jefferies Financial	United States
Caesars Entertainment	United States
Chemours	United States
Blom Bank	Lebanon
Daelim Industrial	South Korea
HELLA	Germany
Haseko	Japan
ON Semiconductor Corp.	United States
AMP	Australia
Jabil Circuit	United States
Noble Energy	United States
Tech Mahindra	India
World Fuel Services	United States
AutoNation	United States
CPFL Energia	Brazil
KWG Group Holdings	Hong Kong
GS Engineering	South Korea
Pearson	Japan
Starwood Property Trust	United States
General Insurance Corporation Of India	India
Hokuhoku Financial Group	Japan
Taylor Wimpey	United Kingdom
Community Health Systems	United States
SG Holdings	Japan
Vulcan Materials	United States
Samsung Electro-Mechanics	South Korea
Guangzhou Baiyunshan Pharmaceutical Holdings	China
News Corp	United States
Tahoe Group	China
Qingdao Rural Commercial Bank	China
SBI Holdings	Japan
Almarai	Saudi Arabia
Frontier Communications	United States
New York Community Bancorp	United States
Xiamen Xiangyu	China
UGI	United States
Mowi ASA	Norway
MTU Aero Engines AG	Germany
NiSource	United States
LEG Immobilien AG	Germany
Hopson Development Holdings	Hong Kong
ServiceNow	United States
IHI	Japan
Workday	United States
Alcoa	United States
Old Dominion Freight Line	United States
Air Canada	Canada
Wistron	Taiwan
Citrix Systems	United States
Tiffany & Co.	United States
EMS-Chemie Holding	Switzerland
Banco Comercial Portugues	Portugal
Avery Dennison	United States
Hertz Global Holdings	United States
First Quantum Minerals	Canada
Symantec	United States
Times Property Holdings	China
Nishi-nippon Financial Holdings	Japan
Kyushu Financial Group	Japan
China Resources Gas Group	Hong Kong
Pan Pacific International Holdings	Japan
Yamaguchi Financial	Japan
NSK	Japan
Hachijuni Bank	Japan
Ajinomoto	Japan
Olympus	Japan
Kansas City Southern	United States
Gjensidige Forsikring	Norway
Renesas Electronics	Japan
Caltex Australia	Australia
Luzhou Lao Jiao	China
Match Group	United States
SS&C Technologies	United States
Autodesk	United States
Sun Pharma Industries	India
North Pacific Bank	Japan
Uniqa	Austria
Pirelli	Italy
Alexandria Real Estate Equities	United States
Banco Davivienda	Colombia
Csc Financial	China
PBF Energy	United States
Luxshare Precision Industry	China
Minebea	Japan
Rajesh Exports	India
Bank of Kyoto	Japan
Align Technology	United States
PGE Polska Grupa Energetyczna	Poland
Hiroshima Bank	Japan
Zhejiang Longsheng Group	China
Fastighets Balder	Sweden
INTL FCStone	United States
Latam Airlines	Chile
BOK Financial	United States
Quilter	United Kingdom
Essex Property Trust	United States
Cullen/Frost Bankers	United States
Guangdong Investment	Hong Kong
China Resources Cement Holdings	Hong Kong
Shimano	Japan
Ares Capital	United States
77 Bank	Japan
Kangmei Pharmaceutical	China
Banque Cantonale Vaudoise	Switzerland
Chugoku Bank	Japan
Tosoh	Japan
Ultrapar Participacoes	Brazil
LG Uplus	South Korea
Metropolitan Bank & Trust	Philippines
Newell Brands	United States
Chongqing Changan Auto	China
Petro Rabigh	Saudi Arabia
Tingyi Holding	China
SLM	United States
National Bank of Greece	Greece
Merlin Properties SOCIMI S.A	Spain
SYNNEX	United States
Copart	United States
Gunma Bank	Japan
Bank Muscat	Oman
Toll Brothers	United States
Acciona	Spain
GPT Group	Australia
Shenzhen Mindray Bio-Medical Electronics	China
Mr. Cooper Group	United States
Burlington Stores,	United States
Piraeus Bank	Greece
Yunnan Baiyao Group	China
Companhia Brasileira de Distribuicao	Brazil
Erdemir	Turkey
Avis Budget Group	United States
Frasers Property Limited	Singapore
Whitbread	United Kingdom
Invitation Homes	United States
Alpha Bank	Greece
Hyundai Glovis	South Korea
Novozymes	Denmark
Mizrahi Tefahot Bank	Israel
Wärtsilä	Finland
Foot Locker	United States
Alaska Air Group	United States
Square	United States
Iyo Bank	Japan
Nippon Steel Trading	Japan
China Longyuan Power	China
Eurobank Ergasias	Greece
Ralph Lauren	United States
Deutsche Pfandbriefbank	Germany
Safaricom	Kenya
New Hope Liuhe	China
Unicaja Banco	Spain
Rite Aid	United States
Far Eastern New Century	Taiwan
Industrivarden	Sweden
W.P. Carey	United States
Steel Authority of India	India
Everbright Securities	China
Wayfair	United States
Jiangsu Zhongnan Construction Group	China
Mercuries & Associates	Taiwan
Snap-on	United States
Liuzhou Iron & Steel	China
Suzuken	Japan
China Aviation Oil	Singapore
China National Chemical	China
Nielsen	United States
Sterling Bancorp	United States
Pinduoduo	China
DGB Financial Group	South Korea
Commercial Bank of Qatar	Qatar
Avnet	United States
Viva Energy Group	Australia
Kingboard Holdings	Hong Kong
Moscow Exchange	Russia
Adani Ports & Special Economic Zone	India
Great Eagle Holdings	Hong Kong
Cabot Oil & Gas	United States
BayWa	Germany
Juroku Bank	Japan
Synovus Financial	United States
Hyakugo Bank	Japan
Fluor	United States
Cybg	United Kingdom
FinecoBank	Italy
Commercial Bank For Investment & Development Of Vietnam	Vietnam
Empire	Canada
Hakuhodo DY Holdings	Japan
Rexel	France
JG Summit Holdings	Philippines
Inner Mongolia Yitai Coal	China
Hengan International Group	China
ResMed	United States
Wendel	France
Fuyao Glass Industry Group	China
Seiko Epson	Japan
Shiga Bank	Japan
Banco de Chile	Chile
Banca Mediolanum	Italy
Hanwa	Japan
Atmos Energy	United States
IDBI Bank	India
Arista Networks	United States
Burelle	France
Martin Marietta Materials	United States
Metalurgica Gerdau	Brazil
Atlassian	United Kingdom
Shopify	Canada
Performance Food Group	United States
Toho Bank	Japan
First Citizens Bank	United States
Taiwan Business Bank	Taiwan
WPG Holdings	Taiwan
Advanz Pharma	Canada
Tokyu Fudosan	Japan
First Pacific	Hong Kong
Ogaki Kyoritsu Bank	Japan
Vingroup	Vietnam
Ansys	United States
SinoPac Financial	Taiwan
San-In Godo Bank	Japan
Wirecard	Germany
Nanto Bank	Japan
Universal Entertainment	Japan
Mirvac Group	Australia
Grupo Bolivar	Colombia
Constellation Software	Canada
Albemarle	United States
Bank of Xi'an	China
Adient	Ireland
Zain	Kuwait
IDEXX Laboratories	United States
Sansteel Minguang	China
RMB Holdings	South Africa
Bendigo & Adelaide Bank	Australia
Aozora Bank	Japan
Red Star Macalline Group	China
Central Bank of India	India
Founder Securities	China
Vietin Bank	Vietnam
Senshu Ikeda Holdings	Japan
Syndicate Bank	India
Celltrion	South Korea
Inventec	Taiwan
Orient	Japan
Credito Emiliano	Italy
SDIC Capital	China
Indiabulls Housing Finance	India
Tokyo Kiraboshi Financial Group	Japan
Aareal Bank	Germany
Sembcorp Industries	Singapore
China Zhongwang Holdings	China
PacWest Bancorp	United States
Palo Alto Networks	United States
NH Investment & Securities	South Korea
SBA Communications	United States
Hyatt Hotels	United States
Tenneco	United States
Core-Mark Holding	United States
Vodafone Idea	India
MercadoLibre	Argentina
Adyen	Netherlands
Hanesbrands	United States
Longi Green Energy Technology	China
Barry Callebaut	Switzerland
Axiata Group	Malaysia
Banca Popolare di Sondrio	Italy
Liberty Broadband	United States
Suzano Papel e Celulose	Brazil
China Oriental Group	Hong Kong
Sinotrans Ltd.	China
Berry Global Group	United States
President Chain Store	Taiwan
Juniper Networks	United States
Canadian Utilities	Canada
CSPC Pharmaceutical Group	Hong Kong
Broadridge Financial	United States
Chipotle Mexican Grill	United States
Navistar International	United States
Bank of Qingdao	China
China Railway Signal & Communication	China
Liberbank	Spain
Nuernberger Beteiligungs	Germany
Sofina	Belgium
Yes Bank	India
Muyuan Foodstuff	China
Bank of Jiujiang	China
China Development Bank Financial Leasing	China
United Utilities	United Kingdom
JTEKT	Japan
Keiyo Bank	Japan
Basler Kantonalbank	Switzerland
Japan Securities	Japan
Commercial International Bank	Egypt
Alfa Laval	Sweden
China Merchants Expressway Network & Technology Holdings	China
Hyakujushi Bank	Japan
Commerce Bank	United States
Dali Foods Group	China
Financial Street Holdings	China
Hokkoku Bank	Japan
Asian Paints	India
Haidilao International Holding	China
Old Republic International	United States
Oshkosh	United States
Cemig	Brazil
Credit Bank of Moscow	Russia
Fangda Carbon New Material	China
Yamada Denki	Japan
Hengyi Petrochemical Co., Ltd.	China
Xinhu Zhongbao	China
Jaccs	Japan
Zalando	Germany
Informa plc	United Kingdom
Garrett Motion	Switzerland
Medical Properties Trust	United States
Nanya Technology	Taiwan
Sydney Airport	Australia
Kiyo Bank	Japan
International Flavors & Fragrances	United States
JB Financial Group	South Korea
Smurfit Kappa Group	Ireland
Fraport	Germany
Piramal Enterprises	India
Banque Centrale Populaire	Morocco
FMC	United States
Konica Minolta Business Solutions	Japan
Sonova Holding	Switzerland
F.N.B.	United States
Fibra Uno	Mexico
Lotte	South Korea
Musashino Bank	Japan
Migdal Insurance	Israel
Chimera Investment	United States
Sabesp	Brazil
Shanghai Ganglian E-Commerce Holdings	China
EFG International	Switzerland
Cleveland-cliffs	United States
Saudi Arabian Fertilizers	Saudi Arabia
Splunk	United States
Lendlease Group	Australia
Murphy USA	United States
Yageo Corporation	Taiwan
Bureau Veritas	France
Saipem	Italy
United Natural Foods,	United States
Luzerner Kantonalbank	Switzerland
AU Optronics	Taiwan
Marks & Spencer	United Kingdom
Dixons Carphone	United Kingdom
Shoprite Holdings	South Africa
Unisplendour	China
Veeva Systems	United States
Allahabad Bank	India
Credit Acceptance	United States
BBVA Banco Continental	Peru
Indian Bank	India
China Agri-Industries	Hong Kong
Owens Corning	United States
LiveRamp Holdings	United States
Royal Mail	United Kingdom
Cadence Design	United States
Makita	Japan
Nanjing Iron & Steel	China
United Aircraft	Russia
Extra Space Storage	United States
Ipsen	France
Zebra Technologies	United States
H Lundbeck	Denmark
Andhra Bank	India
Bank of Queensland	Australia
Air Lease	United States
Ronshine China Holdings	China
AmBank Group	Malaysia
Prysmian	Italy
VEON	Netherlands
San ju San Financial Group	Japan
Zhejiang Chint Electrics	China
Autoliv	Sweden
Sensata Technologies Holding	United Kingdom
CoStar Group	United States
EasyJet	United Kingdom
Sears Holdings	United States
Western Alliance Bancorp.	United States
Meritz Securities	South Korea
Cimarex Energy	United States
VICI Properties	United States
FIBI Holdings	Israel
Oriental Bank of Commerce	India
BJ's Wholesale Club	United States
Bank of Nagoya	Japan
Grupo De Inversiones Suramericana	Colombia
CPI Property Group.	Luxembourg
IBERIABANK	United States
Sino Land	Hong Kong
China Petroleum Engineering	China
Nomura Research Institute	Japan
Nippon Paint	Japan
Thomas Cook Group	United Kingdom
Tomony Holdings	Japan
Isetan Mitsukoshi Holdings	Japan
Toyota Boshoku	Japan
Want Want China	China
F5 Networks	United States
Innolux	Taiwan
Vipshop Holdings	China
Keysight Technologies	United States
iQIYI	China
Tongling Nonferrous Metals	China
Laurentian Bank	Canada
Ramsay Health Care	Australia
Hero Motocorp	India
Samsung Securities	South Korea
SK Networks	South Korea
Yuexiu Property Co.	Hong Kong
Synnex Technology Intl	Taiwan
Li & Fung	Hong Kong
Jointown Pharmaceutical Group	China
Kuwait Projects	Kuwait
Land Securities Group	United Kingdom
Lyft	United States
Corporation Bank	India
Sunny Optical Technology Group	China
Delek Group	Israel
Sichuan Changhong Electric	China
Wintrust Financial	United States
Indian Overseas Bank	India
RusHydro	Russia
AAC Technologies Holdings	China
Associated Banc-Corp	United States
Burberry Group	United Kingdom
Catcher Technology	Taiwan
Zenith Bank	Nigeria
Grupo Carso	Mexico
Marvell Technology Group	Bermuda
St. Galler Kantonalbank	Switzerland
Lundbergs	Sweden
Sumec Corporation	China
Berkeley Group Holdings	United Kingdom
Inchcape	United Kingdom
Asustek Computer	Taiwan
Digital China Group	China
ISS	Denmark
AVIC International Holdings	China
Goldcorp	Canada
Booz Allen Hamilton Holding	United States
Drilling Company of 1972	Denmark
Canadian Apartment Properties Real Estate Investment Trust	Canada
Kesko	Finland
Securitas	Sweden
Bid	South Africa
Lanxess	Germany
Nippon Paper Industries	Japan
CBOE Global Markets	United States
Saras	Italy
Daily Mail & General Trust	United Kingdom
Mitsubishi Gas Chemical Company,	Japan
Thanachart Capital	Thailand
Korea Zinc	South Korea
Bank OZK	United States
Grupa LOTOS	Poland
Snap	United States
Taiwan Cement	Taiwan
TP ICAP	United Kingdom
IDEX	United States
Thai Oil	Thailand
Bed Bath & Beyond	United States
Incyte	United States
Fuyo General Lease	Japan
JC Penney	United States